NO ./path_to_the_north_textureNO
SO ./path_to_the_south_textureSO
WE ./path_to_the_west_textureWE
EA ./path_to_the_east_textureEA

F 255,255,255
C 0,0,0

1111111111111111
1010001001000101
1010100001010001
1010100001010001
1010100001010001
1010110001011001
1000110000011001
1111111011111101
1010001001000101
1010100001010001
101E000001010001
1010100001010001
1011110001011001
1011100000110011
1111111111111111