NO textures/461223184.xpm42
SO textures/fog.xpm42
WE textures/jellyfish.xpm42
EA textures/sea.xpm42

F 33,7,73
C 191,189,193

1111111111111111
1S10001001000101
1010100001010001
1010100001010001
1010100001010001
1010110001011001
1000110000011001
1111111011111101
1010001001000101
1010100001010001
1010000001010001
1010100001010001
1011110001011001
1011100000110011
1111111111111111