NO ./path_to_the_north_textureNO
SO ./path_to_the_south_textureSO
WE ./path_to_the_west_textureWE
EA ./path_to_the_east_textureEA

F 250,34,9
C 225,37,1

       1111111111111111111111111
       1000000000110000000000001
       1011000001110000001110001
       1001000000000000001 10001
11111111101100000111000001110001
100000000011000001110111111111111
11110111111111011100000010001
11110111111111011101010010001
11000000110101011100000010001
10000000000000001100000010001
10000000000000001101010010001
11000001110101011111011110N0111
11110111 1110101 101111010001111
11111111 1111111 111111111111