NO textures/1.xpm42
SO textures/2.xpm42
WE textures/3.xpm42
EA textures/4.xpm42

F 245,213,148
C 111,137,152

1111111111111111
1010001001000101
1010100001010001
101010S001010001
1010100001010001
1010110001011001
1000110000011001
1111111011111101
1010001001000101
1010100001010001
1010000001010001
1010100001010001
1011110001011001
1011100000110011
1111111111111111