NO textures/6.xpm42
SO textures/7.xpm42
WE textures/8.xpm42
EA textures/9.xpm42
F 20,35,125
C 123,123,123

1111    1111111111111111111111111
1001    1000100000110000000000001
1001    1011000001110000000000001
1001    1000000000000000000000001
111111111011000001110000000000001
100000000011100001110111111111111
11110111111111011100000010001
11110111111111011101010010001
11000000110101011100000010001
10000000000000001100000010001
10000000000000001101010010001
1100000111010101111101111000111
11110111 1110101 101111010001
11111111 1111111 111111111111
